+--+--+--+--+--+--+
|        |        |
+  +--+  +  +--+  +
|  |     |        |
+  +  +--+--+  +--+
|  |           |  |
+--+  +--+--+  +  +
|     |     |  |  |
+  +--+  +  +  +  +
|  |     |  |  |  |
+  +  +--+  +--+  +
|  |           |  |
+  +--+--+--+  +  +
|              | g|
+--+--+--+--+--+--+