+--+--+--+--+--+
|     |        |
+  +  +  +--+  +
|  |  |     |  |
+  +--+--+  +  +
|           |  |
+  +--+--+--+  +
|  |        |  |
+  +  +--+  +  +
|  |     |     |
+  +--+  +--+  +
|           | g|
+--+--+--+--+--+